Abkhazie 	Abkhaze
Abyssinie 	Abyssinien
Afghanistan 	Afghan
Afrique du Sud 	Sud-Africain
Åland 	Aalandais
Albanie 	Albanais
Alberta 	Albertain
Algérie 	Algérien
Allemagne 	Allemand
Allemagne de l'Est	Est-Allemand
Allemagne de l'Ouest	Ouest-Allemand
Alsace 	Alsacien
Andorre 	Andorran
Angola 	Angolais
Anguilla 	Anguillan
Annam 	Annamite
Antarctique ou Antarctide 	Antarcticain
Antigua-et-Barbuda 	Antiguais-Barbudien
Antigua 	Antiguais
Barbuda 	Barbudien
Aquitaine 	Aquitain
Arabie saoudite 	Saoudien
Aragon 	Aragonais
Arcadie 	Arcadien
Argentine 	Argentin
Arménie 	Arménien
Aruba 	Arubéen, Arubain
Asie 	Asiatique
Assyrie 	Assyrien
Asturies 	Asturien
Aunis 	Aunisien
Aurigny 	Aurignais
Australie 	Australien
Autriche 	Autrichien
ex-Autriche-Hongrie 	ex-Austro-Hongrois
Azerbaïdjan 	Azéri (féminin Azérie), Azerbaïdjanais
Bahamas 	Bahaméen, Bahamien
Bahreïn 	Bahreïni (féminin Bahreïnie), Bahreïnite
Baléares 	Baléare
Bali 	Balinais
Bangladesh 	Bangladeshi (féminin Bangladeshie), Bangladais
Barbade 	Barbadien
pays Basque 	Basque, Basquais, Euscarien
Bélarus ou Biélorussie 	Bélarusse, Biélorusse
Belgique 	Belge
Belize 	Bélizien
Bengale 	Bengali, Bengalais
Bénin 	Béninois
ex-Dahomey 	ex-Dahoméen
Bermudes 	Bermudien
Bhoutan 	Bhoutanais
Biafra 	Biafrais
Birmanie 	Birman
Bolivie 	Bolivien
Bonaire 	Bonairien
Bophuthatswana 	Tswana (masculin et féminin identiques)
Bosnie	Bosnien
Botswana 	Botswanais
Brésil 	Brésilien
Brunéi ou Brunei 	Brunéien, Bruneien
Bulgarie 	Bulgare
Burkina Faso 	Burkinabè (accord régulier ou invariable), Burkinabé (accord régulier ou invariable), Burkinais, Burkinabais, Burkinabe, Burkina-be, Burkina-fassien
ex-Haute-Volt	ex-Voltaïque
Burundi ou Bouroundi 	Burundais, Bouroundais
îles Caïmanes ou îles Caïmans 	Caïmanais, Caïmanien
Cambodge	Cambodgien, Khmer (féminin Khmère))
ex-Kampuchea 	ex-Kampuchéen
Cameroun 	Camerounais
Canada 	Canadien
Canaries 	Canarien
Cap-Vert 	Cap-Verdien, Capverdien
Ceylan 	Cingalais, Cinghalais, Ceylanais
Chaldée	Chaldéen
Chili 	Chilien
Chine 	Chinois
Chypre 	Chypriote, Cypriote
Ciskei 	Ciskéien
Colombie 	Colombien
Colombie-Britannique 	Britanno-Colombien
Comores 	Comorien
Congo	Congolais
ex-Zaïre 	ex-Zaïrois
îles Cook 	Cookien
Corée du Nord 	Coréen, Nord-Coréen
Corée du Sud 	Coréen, Sud-Coréen
Costa Rica 	Costaricain, Costaricien
Côte d’Ivoire 	Ivoirien
Croatie 	Croate
Cuba 	Cubain
Danemark 	Danois
Djibouti 	Djiboutien
Dominique 	Dominiquais
Écosse 	Écossais
Égypte 	Égyptien
Émirats arabes unis 	Émirien, Émirati (féminin Émiratie)
Équateur 	Équatorien
Érythrée 	Érythréen
Espagne 	Espagnol
Estonie 	Estonien, Este
États-Unis d’Amérique ou États-Unis 	Américain, États-Unien, Étatsunien, Étasunien, Ricain, Amerloque, Amerlot
Éthiopie 	Éthiopien
ex-Abyssinie 	ex-Abyssinien
îles Falkland ou îles Malouines 	Falklandais, Malouin
îles Féroé 	Féroïen
Fidji 	Fidjien
Finlande 	Finlandais
France 	Français
Gabon 	Gabonais
pays de Galles 	Gallois
Gambie 	Gambien
Géorgie 	Géorgien
Ghana 	Ghanéen
Gibraltar	Gibraltarien
Grande-Bretagne 	Britannique, Grand-Breton
Grèce 	Grec (féminin Grecque), Hellène
Grenade 	Grenadien, Grenadin
Groenland	Groenlandais
Guadeloupe 	Guadeloupéen
Guam 	Guamien
Guatemala 	Guatémaltèque
Guernesey 	Guernesiais
Guinée 	Guinéen
Guinée-Bissau ou Guinée-Bissao 	Bissau-Guinéen, Bissao-Guinéen
Guinée équatoriale 	Équato-Guinéen
Guyana 	Guyanien, Georgetownien
Guyane française 	Guyanais
Haïti 	Haïtien
Hawaï 	Hawaïen
Herm 	Hermais
Honduras 	Hondurien
Hong-Kong 	Hongkongais
Hongrie 	Hongrois, Magyar
Île-de-France 	Francilien
Île-du-Prince-Édouard 	Prince-Édouardien
Inde 	Indien
Indochine	Indochinois
Indonésie 	Indonésien
Iran 	Iranien
Iraq ou Irak 	Iraquien, Irakien
Irlande 	Irlandais
Irlande du Nord 	Nord-Irlandais
Islande 	Islandais
Israël 	Israélien
Italie 	Italien
Jamaïque 	Jamaïcain
Japon 	Japonais, Nippon
Jersey 	Jersiais
Jéthou 	Jéthouais
Jordanie 	Jordanien
Kazakhstan 	Kazakh (féminin Kazakhe)
Kenya 	Kenyan, Kényen
îles Kerguelen 	Kerguelenois, Kerguelénois
Kirghizstan 	Kirghize, Kirghiz (féminin Kirghize), Kirguize
Kiribati  	Kiribatien, Kiribati (féminin Kiribatie)
ex-îles Gilbert 	ex-Gilbertin
Koweït 	Koweïti (féminin Koweïtie), Koweïtien
Kurdistan 	Kurde
Labrador 	Labradorien
Laos 	Laotien
Laponie 	Lapon
Lesotho 	Lesothan, Loti (pluriel Maloti), Sotho (masculin et féminin identiques)
Lettonie 	Letton
Levant 	Levantin
Liban 	Libanais
Libéria ou Liberia 	Libérien
Libye 	Libyen
Liechtenstein 	Liechtensteinois
Lituanie ou Lithuanie 	Lituanien, Lithuanien
Luxembourg 	Luxembourgeois
Macao 	Macanais, Macanéen, Macaois
Macédoine 	Macédonien
Madagascar 	Malgache
Madère 	Madérien, Madérois
Malaisie 	Malaisien
Malawi 	Malawien, Malawite
Maldives 	Maldivien
Mali 	Malien
Malte 	Maltais
île de Man 	Mannois
îles Mariannes	Mariannais
Maroc 	Marocain
îles Marshall 	Marshallais
Martinique 	Martiniquais
Maurice 	Mauricien
Mauricie	Mauricien
Mauritanie 	Mauritanien
Mayotte	Mahorais
Mélanésie 	Mélanésien
Mésopotamie	Mésopotamien
Mexique 	Mexicain
Micronésie 	Micronésien
Moldavie, Moldova 	Moldave, Moldove
Monaco 	Monégasque
Mongolie 	Mongol
Monténégro 	Monténégrin
Montserrat 	Montserratien
Mozambique 	Mozambicain, Mozambicais
Myanmar 	Myanmarais, Myanmarien
ex-Birmanie 	ex-Birman
Namibie 	Namibien
Nauru 	Nauruan
Navarre 	Navarrais, Navarrin
Népal 	Népalais
Nicaragua 	Nicaraguayen
Niger 	Nigérien
Nigéria ou Nigeria 	Nigérian
Nioué ou Niue 	Niouéen
île Norfolk 	Norfolkais
Norvège 	Norvégien
Nouvelle-Calédonie 	Néo-Calédonien, Canaque, Caldoche
Nouvelle-Zélande 	Néo-Zélandais
Oman 	Omani (féminin Omanie), Omanais
Ossétie 	Ossète, Ossétien
Ouganda 	Ougandais
Ouzbékistan 	Ouzbek (masculin et féminin identiques ; autre féminin possible : Ouzbèke), Ouzbèque
Pakistan 	Pakistanais
Palaos ou Belau 	Palaosien
Palestine 	Palestinien
Panamá 	Panaméen, Panamien
Papouasie-Nouvelle-Guinée 	Papouan-Néo-Guinéen, Papouasien, Néo-Guinéen
Paraguay 	Paraguayen
Pays-Bas 	Néerlandais, Hollandais
Pérou 	Péruvien
Perse 	Persan
Phénicie 	Phénicien
Philippines 	Philippin
îles Pitcairn 	Pitcairnais
Pologne 	Polonais
Polynésie 	Polynésien
Polynésie française 	Polynésien
Porto Rico 	Portoricain, Porto-Ricain
Portugal 	Portugais, Lusitanien
Pridnestrovie ou Transnistrie ou Transdnistrie 	Pridnestrovien, Transnistrien, Transdnistrien
Prusse 	Prussien
Qatar 	Qatari (féminin Qatarie), Qatarien
République centrafricaine 	Centrafricain
République dominicaine 	Dominicain
République tchèque 	Tchèque
Réunion	Réunionnais
Roumanie 	Roumain
Royaume-Uni 	Britannique
Russie 	Russe ou Russien
Rwanda ou Rouanda ou Ruanda 	Rwandais, Rouandais, Ruandais
Saba 	Sabéen
Sahara occidental 	Sahraoui (féminin Sahraouie)
Saint-Christophe-et-Niévès ou Saint-Kitts-et-Nevis 	Kitticien-Névicien
Saint-Kitts 	Kittitien, Kitticien
Niévès ou Nevis 	Névicien
Saint-Eustache 	Statien
Saint-Marin 	Saint-Marinais, San-Marinais
Saint-Martin	Saint-Martinois
Saint-Pierre	Saint-Pierrais
Miquelon	Miquelonnais
Saint-Vincent 	Saint-Vincentais
les Grenadines 	Grenadin
Saint-Vincent-et-les Grenadines 	Saint-Vincentais-et-Grenadin
Sainte-Hélène 	Sainte-Hélénien
Sainte-Lucie 	Sainte-Lucien
îles Salomon 	Salomonien, Salomonais
Salvador 	Salvadorien
Samoa 	Samoan
Samoa américaines 	Samoan
Sao Tomé-et-Principe 	Santoméen, Sao-Tomien
Sardaigne 	Sarde
Saskatchewan 	Saskatchewanais ou Saskatchewannais (francophone Fransaskois)
Savoie 	Savoyard
Saxe 	Saxon
Scandinavi 	Scandinave
Sénégal 	Sénégalais
Serbie 	Serbe
Sercq 	Sercquiais
Seychelles 	Seychellois
Siam 	Siamois
Sierra Leone 	Sierra-Léonais, Sierraléonais
Singapour 	Singapourien
Sint-Maarten 	Saint-Martineer
Slovaquie 	Slovaque
Slovénie 	Slovène
romalie 	Somali (féminin Somalie)
Soudan 	Soudanais
Sri Lanka 	Sri-Lankais, Srilankais
ex-Ceylan 	ex-Ceylanais
Suède 	Suédois
Suisse 	Suisse, Helvète
Suriname 	Surinamais
Swaziland 	Swazi (féminin Swazie)
Syrie 	Syrien
Tadjikistan 	Tadjik (féminin Tadjike)
Taïwan 	Taiwanais
ex-Formose 	ex-Formosan
Tanzanie	Tanzanien
Tanganyika 	Tanganyikais
Zanzibar 	Zanzibarais, Zanzibarien
Tasmanie 	Tasmanien
Tchad 	Tchadien
ex-Tchécoslovaquie 	ex-Tchécoslovaque
Tchétchénie 	Tchétchène
Thaïlande 	Thaïlandais
ex-Siam 	ex-Siamois
Tibet 	Tibétain
Timor oriental 	Est-Timorais
Togo 	Togolais
Tokelau ou Tokélaou 	Tokelauien, Tokelauan, Tokélaouan
Tonga 	Tongan, Tonguien
Toscane 	Toscan
Transkei 	Transkéien
Trinité-et-Tobago 	Trinidadien, Trinitien, Tobagonien
Tunisie 	Tunisien
Turkménistan 	Turkmène
Turquie 	Turc
Tuvalu	Tuvaluan, Touvalouan
Touvalou 	Tuvaluan, Touvalouan
ex-îles Ellice 	ex-Ellicien
Ukraine 	Ukrainien
ex-URSS 	ex-Soviétique
Uruguay 	Uruguayen
Vanouatou ou Vanuatu 	Vanuatais, Vanouatais, Vanuatuan, Nivanuatu (invariable)
ex-Nouvelles-Hébrides	ex-Néo-Hébridais
Vatican 	Vatican
Venda 	Venda
Venezuela 	Vénézuélien, Vénézolan
Viêt Nam 	Vietnamien
Viêt Nam du Nord	Nord-Vietnamien
Viêt Nam du Sud	Sud-Vietnamien
Wallis-et-Futuna 	Wallisien, Futunien
Yémen 	Yéménite
ex-Yougoslavie 	ex-Yougoslave
Zambie 	Zambien
Zimbabwe 	Zimbabwéen
ex-Rhodésie	ex-Rhodésien
