Abidjan 	Côte d’Ivoire 	Abidjanais
Abou Dhabi 	Émirats arabes unis 	Aboudhabien
Abuja 	Nigeria 	
Accra 	Ghana 	Accréen
Achgabat 	Turkménistan 	Achgabatais
Addis Abeba, Addis-Abeba 	Éthiopie 	Addis-Abebien
Alger 	Algérie 	Algérois
Almaty 	Kazakhstan 	Almatois
Amman 	Jordanie
Amsterdam 	Pays-Bas 	Amstellodamien, Amstellodamois
Andorre-la-Vieille 	Andorre 	Andorran
Ankara 	Turquie 	Ankarien
Antananarivo 	Madagascar
Apia 	Samoa
Asmara 	Érythrée
Astana 	Kazakhstan 	Astanais
Asuncion 	Paraguay
Athènes 	Grèce 	Athénien
Bagdad 	Irak 	Bagdadien
Bakou 	Azerbaïdjan
Bairiki 	Kiribati
Bamako 	Mali 	Bamakois
Bandar Seri Begawan 	Brunei
Bangkok 	Thaïlande 	Bangkokien
Bangui 	République centrafricaine 	Banguissois
Banjul 	Gambie 	Banjulais
Basseterre 	Saint-Christophe-et-Niévès 	Basseterrien
Belgrade 	Serbie 	Belgradois
Belmopan 	Belize
Berlin 	Allemagne 	Berlinois
Berne 	Suisse 	Bernois
Beyrouth 	Liban 	Beyrouthin
Bichkek 	Kirghizistan 	Bichkékois
Bissau 	Guinée-Bissau 	Bissalien
Bogota 	Colombie 	Bogotanais
Brasilia 	Brésil 	Brasilien
Bratislava 	Slovaquie 	Bratislavien
Brazzaville 	République du Congo 	Brazzavillois
Bridgetown 	Barbade
Bruxelles 	Belgique 	Bruxellois
Bucarest 	Roumanie 	Bucarestois
Budapest 	Hongrie 	Budapestois
Buenos Aires 	Argentine 	Porteño, Buenos-Airien
Bujumbura 	Burundi 	Bujumburien
Le Caire 	Égypte 	Cairote
Canberra 	Australie 	Canberrien
Le Cap 	Afrique du Sud 	Capétonien
Caracas 	Venezuela 	Caracassien
Castries 	Sainte-Lucie
Chisinau 	Moldavie 	Chisinéen
Colombo 	Sri Lanka
Conakry 	Guinée 	Conakryka
Copenhague 	Danemark 	Copenhaguois
Cotonou 	Bénin 	Cotonois
Ciudad de Guatemala 	Guatemala 	Guatémalien
Dacca 	Bangladesh
Dakar 	Sénégal 	Dakarois
Damas 	Syrie 	Damascène
Dar es Salam 	Tanzanie 	Irinopolitain
Delap-Uliga-Darrit 	Marshall
Dili 	Timor oriental
Djibouti 	Djibouti 	Djiboutois
Dodoma 	Tanzanie 	Dodomais
Doha 	Qatar
Douchanbé 	Tadjikistan 	Douchanbéen
Dublin 	Irlande 	Dublinois
Erevan 	Arménie 	Érévanais ou Erevanais
Freetown 	Sierra Leone
Funafuti 	Tuvalu 	
Gaborone 	Botswana 	Gaboronais
Georgetown 	Guyana 	
Guatemala 	Guatemala 	Guatémalien
Hanoï 	Viêt Nam 	Hanoïen
Harare 	Zimbabwe 	Hararais
La Havane 	Cuba 	Havanais
La Haye 	Pays-Bas 	Haguenois
Helsinki 	Finlande 	Helsinkien
Honiara 	Salomon
Islamabad 	Pakistan 	
Jakarta 	Indonésie 	Jakartanais
Jérusalem 	Israël 	Hiérosolymitain, Hyérosolymite
Kaboul 	Afghanistan 	Kabouli
Kampala 	Ouganda 	Kampalais
Katmandou 	Népal 	Katmandais
Khartoum 	Soudan 	Khartoumais
Kiev 	Ukraine 	Kiévien
Kigali 	Rwanda 	Kigalois, Kigalien
Kingston 	Jamaïque 	Kingstonien
Kingstown 	Saint-Vincent-et-les Grenadines 	
Kinshasa 	République démocratique du Congo 	Kinois
Koror 	Palaos 	
Koweït 	Koweït 	Koweïtien, Koweïti
Kuala Lumpur 	Malaisie 	
Libreville 	Gabon 	Librevillois
Lilongwe 	Malawi 	Lilongwais
Lima 	Pérou 	Liménien
Lisbonne 	Portugal 	Lisboète, Lisbonnin, Lisbonnais
Ljubljana 	Slovénie 	Ljubljanais
Lomé 	Togo 	Loméen
Londres 	Royaume-Uni 	Londonien
Luanda 	Angola 	Luandais
Lusaka 	Zambie 	Lusakois
Luxembourg 	Luxembourg 	Luxembourgeois
Madrid 	Espagne 	Madrilène
Majuro 	Marshall 	
Malabo 	Guinée équatoriale 	Malabéen
Malé 	Maldives 	
Managua 	Nicaragua 	Managuayen
Manama 	Bahreïn 	Manaméen
Manille 	Philippines 	Manillais
Maputo 	Mozambique 	Maputais
Mascate 	Oman 	Mascatais
Maseru 	Lesotho 	Masérois
Mbabane 	Swaziland 	Mbabanais
Melekeok 	Palaos 	
Mexico 	Mexique
Minsk 	Biélorussie 	Minskois
Mogadiscio 	Somalie 	Mogali
Monaco 	Monaco 	Monégasque
Monrovia 	Liberia 	Monrovien
Montevideo 	Uruguay 	Montévidéen
Moroni 	Comores 	Moronais
Moscou 	Russie 	Moscovite
Muqdisho 	Somalie 	Mogali
Nairobi 	Kenya 	Nairobien
Nassau 	Bahamas 	Nassavien
Ndjamena 	Tchad 	Ndjaménais, Ndjaménois
New Delhi 	Inde 	Delhiite
Niamey 	Niger 	Niméyen
Nicosie 	Chypre 	Nicosien
Nouakchott 	Mauritanie 	Nouakchottois
Nuku’alofa 	Tonga
Oslo 	Norvège 	Osloïte
Ottawa 	Canada 	Outaouais, Ottavien
Ouagadougou 	Burkina Faso 	Ouagalais
Oulan Bator 	Mongolie
Palikir 	Micronésie
Panama 	Panama
Paramaribo 	Suriname
Paris 	France 	Parisien
La Paz 	Bolivie 	Pacénien
Pékin 	Chine 	Pékinois
Phnom Penh 	Cambodge 	Phnompenhois
Podgorica 	Monténégro 	Podgoricien
Port-Louis 	Maurice 	Port-Louisien
Port Moresby 	Papouasie-Nouvelle-Guinée
Port-Vila 	Vanuatu 	Port-Vilais
Port-au-Prince 	Haïti 	Port-au-Princien
Port-d’Espagne, Port of Spain 	Trinité-et-Tobago
Porto-Novo 	Bénin 	Porto-Novien
Prague 	République tchèque 	Pragois, Praguois
Praia 	Cap-Vert 	Praïen
Pretoria 	Afrique du Sud 	Prétorien
Pyinmana 	Birmanie
Pyongyang 	Corée du Nord 	Pyongyangais, Pyongyangois
Quito 	Équateur 	Quitien
Rabat 	Maroc 	Rabatti, Rbati
Rangoun 	Birmanie 	Rangounais, Rangounois
Reykjavik 	Islande 	Reykjavikois
Riga 	Lettonie 	Riganais, Rigois
Riyad 	Arabie saoudite 	Riyadien
Rome 	Italie 	Romain
Roseau 	Dominique
Saint-Domingue 	République dominicaine 	Domingois
Saint-Georges 	Grenade 	Saint-Georgien
Saint John's 	Antigua-et-Barbuda
Saint-Marin 	Saint-Marin 	Saint-Marinais, San-Marinais
San José 	Costa Rica 	
San Salvador 	Salvador 	Sansalvadorien
Sanaa 	Yémen 	
Santiago 	Chili 	Santiagais
Sao Tomé 	Sao Tomé-et-Principe 	Santoméen
Sarajevo 	Bosnie-Herzégovine 	Sarajévien
Séoul 	Corée du Sud 	Séoulien
Singapour 	Singapour 	Singapourien
Skopje 	Macédoine 	Skopiote
Sofia 	Bulgarie 	Sofiote
Sri Jayewardenepura-Kotte 	Sri Lanka
Stockholm 	Suède 	Stockholmois
Sucre 	Bolivie
Suva 	Fidji
Tachkent 	Ouzbékistan 	Tachkentois
Tallinn 	Estonie 	Tallinnois
Tananarive 	Madagascar 	Tananarivien
Tarawa 	Kiribati
Tbilissi 	Géorgie 	Tbilissien
Tegucigalpa 	Honduras 	Tégucigalpais
Téhéran 	Iran 	Téhéran
Tel-Aviv-Jaffa 	Israël 	Telavivien, Tel avivien
Thimphou 	Bhoutan
Tirana 	Albanie 	Tiranais
Tokyo 	Japon 	Tokoyote, Tokyoïte
Tripoli 	Libye 	Tripolitain
Tunis 	Tunisie 	Tunisois
Vaduz 	Liechtenstein
Vaiaku 	Tuvalu
La Valette 	Malte 	Valettois
Varsovie 	Pologne 	Varsovien
Vatican 	État de la Cité du Vatican 	Vaticanais
Victoria 	Seychelles
Vienne 	Autriche 	Viennois
Vientiane 	Laos 	Vientianais
Vilnius 	Lituanie 	Vilnois
Washington 	États-Unis 	Washingtonien
Wellington 	Nouvelle-Zélande 	Wellingtonien
Windhoek 	Namibie
Yamoussoukro 	Côte d’Ivoire 	Yamoussoukrois
Yangon 	Birmanie
Yaoundé 	Cameroun 	Yaoundéen
Yaren 	Nauru
Zagreb 	Croatie 	Zagrébois
